##################################################
##x###########          ##   ###                 v
## ####        ######## ## ####### ###  ###### ###
## ########### ######## ##    #### ###    ########
## ### #######       ##    ### ### ###### ########
##             ## ######## ### ### ###    ########
############# ### ########     ####### ##      ###
#        #### ### ##### ##### ######   #### ######
#  #  #######     ##### ##### ####### ##### ######
#  #           ########               ###      ###
##################################################